+--+-+-----+-+----+-+-----------+
|  | |     | |    | |           |
|  +-+ +-+ +-+    | |           |
|      | |    +---+ | +-+       |
+------+-++   +---+ | | |  +----+
+-------+-+       +-+ | |  +----+
|       | |           | |       |
|       | +-----------+-+-+     |
|       | +----------+-+--+     |
|  +----+ |          | |        |
|  +----+-+  +-+--+  | |  +-+   |
|            | +-+|  | |  | |   |
|     +-+    | | ||  | |  | |   |
|     | |    | | ||  +-+  | |   |
|     | |    | | ||       | |   |
|     | +--+ +-+ |+-------+-+   |
|     | +--+     |+---------+   |
|     | |        ||             |
|   +-+-+--------+|      +------+
|   |            ||      +------+
|   +-------+-+--+|             |
|           | |  ++  +-+        |
+------+    | |      | |        |
+------+    | |      | +-----+  |
|           | |      | +-----+  |
|   +---+   | |      | |        |
|   |   |   | +------+-++       |
|   ++-++   +-+--+-+----+       |
|    | |         | |            |
|    +-+    +-+  | | +----------+
|   ++++----+ |  | | +-+++------+
|   +-------+ |  +-+   +-+      |
|           | |                 |
+-----------+-+-----------------+