+----++----------------+
|    ||                |
|    |+--------+ +-----+
|    |+--------+ +-----+
|    ||                |
|    ||     +-+        |
|    ||     | |  +-----+
|    ++     | |  +-----+
|           | |        |
|           | |  ++    |
+---------+ | |  ||    |
+---------+ | |  ||    |
|           | |  ||    |
|           | |  ||    |
|           | |  ||   X|
+-----------+-+--++----+